000000000000
00T0000T0000
0000T0000000
00000[0,P]000000
0T0000000000
000000[0,TB, IT['sword']]00000
000000000000
00T0000T0000
00000T0000T0
00T000T00000